11 6
10 5 9 1 10 9 
5 3 7 5 9 2 
6 7 8 5 0 9 
8 2 8 9 7 3 
8 9 6 5 7 5 
2 4 7 8 1 1 
10 9 0 7 10 8 
7 2 8 5 5 7 
6 8 1 4 7 0 
6 1 0 8 4 1 
2 1 9 1 9 1 
0 0